11 
20
%%%%%%%%%%%%%%%%%%%%
%H       %! *      %
%#%   #%%%%%%%%#%%%%
%  E  #% J   P #P  %
%#%%#%%%%%#%%%%#%%%%
%#     %1 #  E #   %
%%%%%  %%%%%%%%#%%%%
%  0%   %%   * #   %
%#%%     %%#%%%%%%%%
%#     P *%#      R%
%%%%%%%%%%%%%%%%%%%%

