10 
20
%%%%%%%%%%%%%%%%%%%%
%     #  %2%#      %
% R*  #   ! #  P E %
% %%%%#     #  %%%#%
%1   %%# H  #  *  #%
%%%   ## %%%#%%%%%%%
%     #  E  #      %
%     #%%%% #      %
% J 0%#   P        %
%%%%%%%%%%%%%%%%%%%%
